
Má leanaim go dian tú siar chun Cairibreach,	If I follow you diligently west to Carbary,
Caillfead mo chiall mura dtriallfair abhaile liom,	I’ll lose my mind if you don’t go home with
me,
Óró, bead ag sileadh na ndeor.	Óró, I’ll be shedding tears.
Ná tar im dheoidh gan mórchuid airgid,	Don't come after me without plenty money,
Stampaí Rí Shacsain go cruinn i dtaisce
agat,	The real stamp of the king of England in your keeping.
Óró, i gcomhair chostais an róid.	Óró, for the costs of the journey.

Ní bheidh cloig ar ár ndornaibh ó rómhar na ngarraithe,	There won’t be blisters on our fists from digging the fields,
Ná ó chruachadh na móna ná an fómhar a leathadh orainn.	Nor from heaping the turf nor the autumn sun shining on us.
Beidh rince fada againn más é is fearra
leat,	We'll have the long dance if that's what you want,
Ór is airgead, ól is beathuisce.	Gold and silver, drink and whiskey.
Óró, fad a mhairfimid beo.	Óró, as long as we live.

Nuair a bhraith an aoileann an oíche
tagtha,	When the maid noticed that the night had arrived,
Is ná fuair sí istigh ná amuigh sa gharraí
mé,	And she didn’t find me inside or out in the garden,
Óró, do chas olagón.	Óró, she sang a lament.
Do phreab sí ina suí, ag caoineadh a cuid
airgid,	She jumped up and lamented the loss of her money,
Dá rá gur mheallas-sa a croí lem' chleasannaibh,	Saying that I wooed her heart with my
tricks,
Óró, fad a mhairfidh sí beo.	Óró, for as long as she lives.

Éirígí a chairde, ní foláir nó go leanfam é,	Arise my friends, I must follow him,
Cuardóm na bánta 'gus ard na
ngarraithe,	I’ll search the grasslands and the hillock with the fields,
Don gCiarraíoch mallaithe, a mheall mo chuid airgid,	For that cursed Kerryman, who attracted my money,
Lena bhréithre bladair, ag diúgadh an chnagaire,	With his flattering words, while draining the naggin,
Óró, is ná feadar cá ngeobhad.	Óró, and I don’t know where I’ll find him.